xxxxxxxxxxxxxxxxxxxxxxxxxxxxxxxxxxxxx
x x x x x x x x x x x x x x x x x x x
x x x x x x x x x x x x x x x x x x x
x   x   x   x   x   x   x   x  x  x x
x x x x x x x x x x x x x x x x x x x
x x x x x x x x x x x x x x x x x x x
x   x   x   x   x   x   x   x  x  x x
x x x x x x x x x x x x x x x x x x x
x x x x x x x x x x x x x x x x x x x
x   x   x   x   x   x   x   x  x  x x
x x x x x x x x x x x x x x x x x x x
x x x x x x x x x x x x x x x x x x x
x   x   x   x   x   x   x   x  x  x x
x x x x x x x x x x x x x x x x x x x
x x x x x x x x x x x x x x x x x x x
x   x   x   x   x   x   x   x  x  x x
x x x x x x x x x x x x x x x x x x x
x x x x x x x x x x x x x x x x x x x
x   x   x   x   x   x   x   x  x  x x
x x x x x x x x x x x x x x x x x x x
x x x x x x x x x x x x x x x x x x x
x   x   x   x   x   x   x   x  x  x x
x x x x x x x x x x x x x x x x x x x
x x x x x x x x x x x x x x x x x x x
x   x   x   x   x   x   x   x  x  x x
XXXXXXXXXXXXXXXXXXXXXXXXXXXXXXXXXXXXX